0,0,0,0,10,0,1,0,0,1,1,1,1,1,1,2,1,2,1,1,1,0,1,1,1,1,3,1,1,0,0,0
1,0,0,0,0,0,0,0,0,0,0,0,0,0,0,0,0,0,0,0,0,0,0,0,0,0,0,0,0,0,0,4
1,0,0,0,0,0,0,0,0,0,0,0,0,0,0,0,0,0,0,0,0,0,0,0,0,0,0,0,0,0,0,4
1,0,0,0,0,0,0,0,0,0,0,0,0,0,0,0,0,0,0,0,0,0,0,0,0,0,0,0,0,0,0,4
1,0,0,0,0,0,0,0,0,0,0,0,0,0,0,0,0,0,0,0,0,0,0,0,0,0,0,0,0,0,0,4
1,0,0,0,0,0,0,0,0,0,0,0,0,0,0,0,0,0,0,0,0,0,0,0,0,0,0,0,0,0,0,4
0,0,0,0,0,1,2,3,4,5,6,7,8,9,10,2,3,4,5,0,0,0,0,0,0,0,0,0,0,0,0,2
1,0,0,0,0,4,1,2,3,4,5,6,7,8,9,10,2,3,4,5,0,0,0,0,0,0,0,0,0,0,0,2
1,0,0,0,0,4,0,1,2,3,4,5,6,7,8,9,10,2,3,4,5,0,0,0,0,0,0,0,0,0,0,2
1,0,0,0,0,0,0,0,1,2,3,4,5,6,7,8,9,10,2,3,4,5,0,0,0,0,0,0,0,0,0,4
1,0,0,0,0,1,0,0,0,1,2,3,4,5,6,7,8,9,10,2,3,4,5,0,0,0,0,0,0,0,0,4
1,0,0,0,0,1,0,0,0,0,1,2,3,4,5,6,7,8,9,10,2,3,4,5,0,0,0,0,0,0,0,4
1,0,0,0,0,0,0,0,0,0,0,1,2,3,4,5,6,7,8,9,10,2,3,4,5,0,0,0,0,0,0,4
1,0,0,0,0,1,0,0,0,0,0,0,0,0,0,0,0,0,0,0,0,0,0,0,0,0,0,0,0,0,0,4
1,0,0,0,0,0,0,0,0,0,0,0,0,1,0,0,0,0,0,0,0,0,0,0,0,0,0,0,0,0,0,3
1,0,0,0,0,0,1,1,1,1,1,1,1,1,1,0,0,0,0,0,0,0,0,0,0,0,0,0,0,0,0,2
1,0,0,0,0,1,0,0,0,0,0,0,0,0,0,0,0,0,0,0,0,0,0,0,0,0,0,0,0,0,0,3
1,0,0,0,0,0,0,0,0,0,0,0,0,0,0,0,0,0,0,0,0,0,0,0,0,0,0,0,0,0,0,4
0,0,0,0,0,0,0,0,0,0,0,0,0,0,0,0,0,0,0,0,0,0,0,0,0,0,0,0,0,0,0,4
1,0,0,0,0,0,0,0,0,0,0,0,0,0,0,0,0,0,0,0,0,0,0,0,0,0,0,0,0,0,0,3
0,0,0,0,0,0,0,0,0,0,0,0,0,0,0,0,0,0,0,0,0,0,0,0,0,0,0,0,0,0,0,4
0,0,0,0,0,0,0,0,0,0,0,0,0,0,0,0,0,0,0,0,0,0,0,0,0,0,0,0,0,0,0,2
0,0,0,0,0,0,0,0,0,0,0,0,0,0,0,0,0,0,0,0,0,0,0,0,0,0,0,0,0,0,0,2
0,0,0,0,0,0,0,0,0,0,0,0,0,0,0,0,0,0,0,0,0,0,0,0,0,0,0,0,0,0,0,4
0,0,0,0,0,1,1,1,1,4,4,4,4,4,4,4,4,2,4,3,2,4,4,4,2,4,0,0,0,0,0,4
